1   1   1   1   1   1   1   1   1   1   1   1   1   1   1   1   1   1   1   1   1   1   1   1
1  100  0   1   1   1   1   1   1   1   1   1   1   1   1   1   1   1   1   1   1   1   1   1
1   0   0   0   0   0   0   0   0   0   0   1   1   1   1   1   1   1   1   1   1   1   1   1
1   1   1   1   1   1   1   1   1   1   0   0   0   0   0   0   1   1   1   1   1   1   1   1
1   1   1   1   1   1   1   1   1   1   0   1   1   1   1   0   1   1   1   0   1   1   1   1
1   1   1   1   1   1   1   1   1   1   0   1   1   1   1   0   1   1   1   0   0   0   0   1
1   1   1   1   1   0   0   0   0   0   0   1   1   1   1   0   0   0   0   0   1   1   1   1
1   1   1   1   1   0   1   1   1   1   1   0   0   1   1   1   0   1   1   1   1   1   1   1
1   1   1   1   1   0   1   1   1   1   1   0   1   1   1   1   0   1   1   1   1   1   1   1
1   1   1   1   1   0   1   1   1   1   1   0   0   0   0   0   0   1   1   1   1   1   1   1
1   1   1   1   1   0   1   1   1   1   1   1   1   1   1   1   0   1   1   1   1   1   1   1
1   1   1   1   1   0   0   0   0   0   1   1   0   0   0   0   0   1   1   1   1   1   1   1
1   1   1   1   1   0   1   1   1   0   1   1   1   1   1   1   0   1   1   1   1   1   1   1
1   1   1   1   1   0   1   1   1   0   1   1   1   1   1   1   0   0   0   0   0   0   1   1
1   1   1   1   1   0   1   1   1   0   0   0   0   1   1   1   1   1   1   1   1   0   1   1
1   1   1   1   1   0   1   1   1   0   1   1   0   0   0   0   0   0   1   1   1   0   1   1
1   1   1   1   1   0   1   1   1   0   1   1   1   0   1   1   1   0   1   1   1   0   1   1
1   1   1   1   1   0   1   1   1   0   0   1   1   0   1   1   1   1   1   1   1   0   1   1
1   1   1   1   1   0   1   1   1   1   1   1   1   0   1   0   0   0   0   0   0  101  1   1
1   1   1   1   1   0   1   1   1   1   1   1   1   1   1   0   1   1   1   1   0   1   1   1
1   1   1   1   1   0   0   0   0   0   0   0   1   1   1   0   1   1   1   1   0   1   1   1
1   1   1   1   1   1   1   1   1   1   1   0   0   1   1   0   1   1   1   1   0   1   1   1
1   1   1   1   1   1   1   1   1   1   1   1   0   1   1   0   1   1   1   1   0   1   1   1
1   1   1   1   1   1   0   0   0   0   0   0   0   1   1   0   1   1   1   1   0   1   1   1
1   1   1   0   0   0   0   1   1   1   1   1   1   1   1   0   0   0   1   1   0   1   1   1
1   1   1   0   1   1   0   0   0   0   0   0   0   0   0   0   1   0   1   1   1   1   1   1
1   1   1   0   1   1   1   1   1   1   1   1   1   1   1   1   1   0   1   1   1   1   1   1
1   1   1   0   1   0   1   1   0   0   0   0   0   0   0   0   0   0   1   1   1   1   1   1
1   1   1   0   0   0   1   1   0   1   1   1   1   1   1   1   1   1   1   1   1   1   1   1
1   1   1   1   1   1   1   1   0   0   0   0   1   1   1   1   1   1   1   1   1   1   1   1