  0   0   0   0   0   0   0   0   0   0
100   0   0   1   0   0   1   1   1 101
100   0   0   1   0   0   0   0   1 101
100   1   1   1   0   0   0   0   1 101
  0   0   0   0   0   0   0   0   0   0