0   0  101  0   0   0  101  0   0
0   1   1   1   0   1   1   1   0
0   0   0   0   0   0   0   0   0
0   0   0   0   0   0   0   0   0
0   0   0   0   0   0   0   0   0
0   0   0   0   0   0   0   0   0
0   0   0   0   0   0   0   0   0
0   0   0   0   0   0   0   0   0
0   0   0   0   0   0   0   0   0
0   0   0   0   0   0   0   0   0
0   0   0   0   0   0   0   0   0
0   0   0   0   0   0   0   0   0
0   0   0   0   0   0   0   0   0
0   1   1   1   0   1   1   1   0
0   0  100  0   0   0  100  0   0